11111
1PC11
10011
10011
10011
10011
10011
10011
10011
10011
10011
10011
10011
10011
10011
10011
10011
10E11
10011
10011
10011
10011
10011
10011
10011
10011
10011
10011
10011
10011
10011
10011
10011
10011
10011
10011
10011
10011
10011
10011
10011
10011
10011
10011
10011
10011
10011
10011
10011
10011
11111