1111
1PC1
1001
1001
1001
1001
10E1
1111