11111111
1P0000C1
100000E1
11111111