11111111
1PC00001
10000001
10011111
10011111
10011111
10E11111
11111111