111111
10P001
10C001
101111
10CEC1
111111