111111
100C01
10X0E1
10P001
111111