11111111
1P0110C1
10001001
10010001
10001001
10010001
10010001
10010001
1000C001
10000001
1C0000E1
11111111