1111111111
100x000001
1000C00001
1000000001
10000000E1
10000000E1
10000000E1
10000000E1
10000000E1
10000000E1
1111111111