1111111111
100x000001
1000C00001
10P0000001
1111111111