111111
1P0001
10C001
101111
10CEC1
111111