1111
1P01
1001
10X1
1001
1C01
1E01
1111