1111
1001
1001
10X1
1001
1C01
1E01
1111